        NO images/texture/3.xpm
        SO    images/texture/1.xpm      
WE images/texture/2.xpm 
EA images/texture/4.xpm
F 64,64,64
C 169,175,181

11111111111111111111111111111111
100E0C00000100000000000011111111
1011010001C100001000000011111111
10010000000000000000000011111111
11111111101000000111000000000001
10000000001100000111011111111111
11110111111111100100000000010001
11110111111111000101010010000001
11000000110101011100000010000001
10000000000000001100000010000001
10000000000000001101010010000001
11000001110101011111011110000111
11110111110101101111010000000111
111111111111111111111111111111111111