        NO ./path_to_the_north_texture
        SO              ./path_to_the_south_texture         
WE ./path_to_the_west_texture
EA ./path_to_the_east_texture
F 220,200,22
C 250,30,0

11111111111111111111111111111111
1E000000001100000000000011111111
10110000011100001000000011111111
10010000000000000000000011111111
11111111101100000111000000000001
10000000001100000111011111111111
11110111111111100100000000010001
11110111111111000101010010000001
11000000110101011100000010000001
10000000000000001100000010000001
10000000000000001101010010000001
11000001110101011111011110000111
11110111110101101111010000000111
11111111111111111111111111111111