        NO images/texture/3.xpm
        SO    images/texture/1.xpm      
WE images/texture/2.xpm 
EA images/texture/4.xpm
F 64,64,64
C 169,175,181

11111111111111111111111111111111
100E0C00001100000000000011111111
101101111111111111111111111111111111111
11111111111111111111111111111111