        NO images/AnyConv.com__redstone_lamp_on.xpm
        SO    images/stonebrick.xpm        
WE images/prismarine_dark.xpm   
EA images/prismarine_dark.xpm  
F 17,124,19
C 15,157,215


11111
10001
10101
10001
10N01
11111