        NO images/texture/3.xpm
        SO    images/texture/1.xpm      
WE images/texture/2.xpm 
EA images/texture/4.xpm
F 64,64,64
C 169,175,181

1111111111111111111111111111111111111111111111111111111111
10000C0000010000000000001110111111111000000000000000000001
1011010000011C1110000000C000011111100000000010000001111111
1001000000000000000000001111111111000000000111000001000001
1111111100000N00011100000000000110000100000010000001110001
1000000000110000011101111111111110001110000010000001100001
111111C111111110010000000001000110011C11000000000001100001
1111100000111100010101001000000C00000000000000000000110001
110000001101010111000000100000011000000000111111111C110001
100000000000000011000000C000000110000000000011000000000001
1000000000000000110101001000000110000000001111100000000001
1100000111010101111101C11000011111000000000000000011110001
1111011111010110101101000000011111011111110000000000000001
1111111111111111111111111111111111111111111111111111111111