        NO images/texture/texture2/3.xpm
        SO    images/texture/texture2/1.xpm      
WE images/texture/texture2/5.xpm 
EA images/texture/texture2/4.xpm
F 57,130,131
C 18,106,121

11111111111111111111111111111111
100E0C00001100000000000011111111
10110100011100001000000011111111
10010000000000000000000011111111
11111111101100000111000000000001
10000000001100000111C11111111111
11110111111111100100000000010001
11110111111111000101010010000001
11000000110101011100000010000001
10000000000000001100000010000001
10000000000000001101010010000001
11000001110101011111011110000111
11110111110101101111010000000111
11111111111111111111111111111111